helo : halo hele helio hell hello helm heloe help hero ohelo
thsi :
simole : simile simple
contains : contain
numer : fumer namer number numen numero
fmisspellings :
cna : ana ca cha na ona
eout : bout dout gout lout mout out pout rout tout
yuo : duo quo yeo yo yuh yus
ot : at bot cot dot fot got hot it jot lot
genteat : geneat
filse : false file filose fils fise gilse
otu : tu utu
shwat : shat sheat shoat swat
behvaior :
liek : leek lek lick lie lied lief lien lier lieu link
types : type typer
erors : eros
hpe : ape he hie hipe hoe hope hue ope
uareenjoying :
programming :
types : type typer
eles : els elves exes
closes : close closed closen closer closet
ime : ame dime eme ice ide ie ife imbe imi imp
words : word wordy works
spelled : shelled smelled speller swelled
aeronauticle :
seeworthy : seaworthy
transmogrificatoin :
salutaytion : salutation
thigns :
thati : chati that thatn thats
words : word wordy works
bh : ah b ba bah be bo bu by eh h
itz : it its litz
ulc : ula ule ull ulu
ivo : avo iao io iso iva ivy iyo
